6 6
+ +-+-+-+-+-+
|         | |
+-+-+-+-+ + +
|     |   | |
+ + + + +-+ +
| | | | |   |
+-+ +-+ + +-+
|   |   |   |
+ +-+ +-+ + +
|     |   | |
+ +-+-+-+-+ +
|           |
+-+-+-+-+-+ +

