9 9
+ +-+-+-+-+-+-+-+-+
|   |             |
+-+ +-+ +-+-+-+-+ +
| |   |     |     |
+ +-+ +-+-+ +-+-+-+
|   |     | |     |
+ + +-+-+ + + +-+ +
| |   |   |   |   |
+-+ +-+ +-+ +-+ +-+
|   |   |     |   |
+ +-+ +-+ +-+-+-+ +
|   | |   |     | |
+ + + +-+-+ +-+ + +
| |   |     | |   |
+ +-+-+ +-+-+ +-+ +
|   |   |   |   | |
+-+ + +-+ +-+ + + +
|     |       |   |
+-+-+-+-+-+-+-+-+ +