8 8 
+ +-+-+-+-+-+-+-+
|     |         |
+-+-+ + + +-+-+ +
| |   | |     | |
+ + +-+ +-+-+ +-+
|   | | |   |   |
+ +-+ + + + +-+ +
| |   | | |     |
+ +-+ + + +-+-+ +
|   |   | |     |
+-+ +-+-+ + +-+-+
| | |     |     |
+ + + +-+-+-+-+ +
| | | |       | |
+ + + + +-+ +-+ +
|     |   |     |
+-+-+-+-+-+-+-+ +