7 7
+ +-+-+-+-+-+-+
|       |     |
+-+-+-+ +-+-+ +
|     |   |   |
+ + + +-+ + + +
| | |   | | | |
+ + +-+-+ + +-+
| |       |   |
+ +-+-+-+-+-+ +
| |         | |
+ + + +-+-+ + +
| | | | |   | |
+ +-+ + + +-+ +
|     |       |
+-+-+-+-+-+-+ +