10 10
+ +-+-+-+-+-+-+-+-+-+
| | |               |
+ + + +-+ +-+-+-+-+ +
| |     | |       | |
+ +-+-+-+ + +-+-+ + +
|   |     |   |   | |
+-+ + +-+-+-+-+ + + +
| |   |         | | |
+ +-+-+ + +-+-+-+-+ +
|     | | |   |     |
+ + +-+ + + + + +-+-+
| | |   |   | | |   |
+ +-+ +-+-+-+ + + +-+
|     | |   | | |   |
+ +-+-+ + + + + +-+ +
|   | |   | | | |   |
+-+ + + +-+ + + + +-+
|   |     | | | |   |
+ +-+-+-+-+ + + +-+ +
|           |       |
+-+-+-+-+-+-+-+-+-+ +