5 5
+ +-+-+-+-+
|   |     |
+-+ +-+ + +
| |   | | |
+ +-+ +-+ +
|   |     |
+ +-+-+-+ +
|         |
+ +-+-+-+-+
|         |
+-+-+-+-+ +