4 4
+ +-+-+-+
| |     |
+ + +-+-+
| |     |
+ +-+ + +
|   | | |
+-+ +-+ +
|       |
+-+-+-+ +
